58 21
##############     $*
##############       
#############       #
  ###########*    ###
   *##########    ###
    $   ########  $  
###*     #########  *
###      ########### 
###       ###########
###    *  *##########
###*       *#########
##        $ ######   
##        * ######   
##   *      #####  * 
###    *    ###### ##
###         #########
###$     * * ########
###  *         ####  
  $             ##   
     *               
 $    *             *
  *   *          *   
          $          
     *         *     
   ##   ######       
 $### ########  *    
   #  #######        
*      #####   *   > 
   *  *#####   *     
      * #####        
 *        ##         
     *   *        ** 
                   ##
      $   * *     ###
                 ####
         *      #####
  * *    #     ######
        ####  #####  
  $  $ ###########   
#      *   $###### * 
#  *$       #####    
 *         *#### *   
   *  *  *  ####@*   
  *   *     #####    
         * ######   $
       @   #####     
 *        #####     *
       #######  $    
      * ######    *  
  *      #####  *    
          $ ## *    *
$*    *     ###  *   
             ###     
             ######  
###    *     * ######
###             ###  
###       *       ** 
###     *  * *       
