71 43
          ######                 ##########
           #####            $    ##########
   $                             ##########
    $                          $ ##########
                                 ##########
               *                      #####
 *                          *          ####
 $      $   *                        $ ####
                  *                     ###
                                        ###
       *                        $        ##
 $        *                                
                        *                  
     $                     *               
           *                               
              *   ###               *      
$     *    $      ### $  $     *  $        
       $   *            ##              *  
             $        ######     $         
       ####           #######              
       ######         #######              
       ######         #######              
   *   #######       *#######     $  *     
      ########        ##########*          
>     #######        ############    * $   
      #######       ####### #####     *    
      #####      * #######   ####   *      
      ##         ########     ##          *
           ##############        *         
 $        ############### *                
          ################                 
       *  #################                
    $*    ##########################*      
     $    ###########################      
           ################# ########      
           ################        $     * 
###        ################     *          
####       ###############                 
#####     ################                 
##########################                 
 #########################                 
  ########################                 
   ######################                  
    ######     ##########                  
    ##### *     #########       *          
    #####        #######          ###  $  *
    ####        *#######         ######    
    ####         #######  *      #######   
  ######         #######         ##########
#########        #######     *     ########
#########     $ $#######      $      ######
#########       ########    *         #####
##########      #######            $   ####
##########       #####                  ###
####*  ##       *                          
##                            *  *$        
#          *                $$      #      
$       $           $           ######     
                             ##########    
#                      $     ##########    
##                ######     ##########    
### *   $        ######## *  ###########   
###        *     #######   $  ##########   
####            ########       #########   
#####           #######         #######    
#####            ######                    
######            #####                 $  
#######            ####                    
#########     *    ####           ##    $  
#########  *     * ####           ##       
#########      $    ### **       ###       
