14 74
###$     *####### *       ########          #   > ######        #     ####
###       #######         #######          ##     ######        #     ####
##       ########        #######           ###    ######        #     ####
##       ########        #######           ###$  #######        *#    ####
#        #######  *     #######           ####   #######         ##   ####
          ####     ############            ##                          ###
       *  ####      ############     *                                 ###
           ###       ###########                                      * ##
            ###       ###  ######  *    *              *   ### *$        *
           $####      #     #####                    *    #####           
            #####    ##      ####   *                    #######         *
       **  *#####   ###       ###     ##               *########          
             ##### ####     $         ###              ##########     *   
             ##########     *          ###             ##########     **  
