17 11
###  # **  
### *##    
  #######$ 
     ##*###
 #       ##
##  #     #
#       *##
*      * ##
   ##      
  *##      
 *  *    * 
##      *  
###    ####
#     > ## 
        #  
 ###  ##   
 #### ##   
