7 6
### # 
#   # 
 >* # 
#    #
#    #
#    #
##@##@