21 44
       ######  ##########         #####     
   $   ######  ##########        ###### $   
       ######  ########    * $* #######     
       ###### $ ######    *  ########## **##
            *    ####  *    ###########  ###
                  ##         #########$ $###
                          *  ######**     # 
                             *####   $   $  
    *             $           ####     *    
   ###       *  *             ###           
###### *          *                     $** 
  ####        $*       #     ##      *      
  ####  *            ##########            *
$ #### *            #######    $       #    
   ##     *       $########                 
#              * * #######                  
                  #######*      ###         
     $            #####   *  $  ####        
    *              ##     ##   ######       
              *      $   $###  #######      
 > *        *          * $###$########      
