14 39
       #    #############$*  ## *      
       #     ############     *     *  
              ######    >              
            * $  ##          *         
*     ##                               
     *#   $       *           *    *   
                 $*      $           $ 
           * *       # $         ##    
                    ###         #######
        $      ##########       #######
     #####     ########################
 *   ###  * $ #########################
# $   #       #######################  
##         #  #### ########   ##   #   
