17 92
###########              ##*                 ###########    * #######       ################
###########              ##                  ###########      #######       ################
###########                                  ##########       #######   $   ################
 ##########                                  ##########       #######       ################
  *#########   ##         ##                #########   *     ########     #########   #####
     ######### ##         ###              ########           ########     #######       ###
      #######             ##              ########            ########     ######           
        ####                              ########     *       #######     #####            
       $                                  #######               ######     ####       >     
     $                           *        #######         ##     ####    *####              
                                          ######         ####             #####             
                ##               ##         ####         ####             ######            
             $  ###  $     $   #####         ##          ####*            ######         $  
                             #######         ##           ###             ######            
                          ##########         ###           ##     *       ######            
                        ###########          ###    $      ##             ######            
                        ###########          ###  $        ##             ######            
