64 55
###############                               $    ####
###############                           *        ####
##############           $    *     $            ######
#############                                   #######
############    $   *                       *   #######
###########         *        @           $     ######* 
##########                    *   #### *$     ###### $ 
########                        #######      ###### $ $
#######       $                 #######    ######## $  
#######                         #######   #########    
########                        ######    #########    
#########                      #####    *  #######     
#########         $           #####        #######    $
######### *    $             #####         $#####   *  
########     $     $    *  ####### $         ####      
######## $*               #######        $    ##  * *$ 
########        ################  $                    
#######         #############                          
#######     *  #############    *   *        >         
######         ############  *  *       *              
#####          ############         ###   *     *     *
              #############    *   ######      ##      
   *          ############         #######   #####     
              ############         ###############     
              ###########       $  ###############     
               ######### *           #############     
      **         #                    ############     
        *  $      $      $          $  ###########     
                                         *$ *  ##      
                       $      $  *                     
      $                             $ *           $    
          *                $   @                *   *  
  #####                                       *   $    
########            *                   $         *    
########                 *                             
########                $                       *      
#######        ##        *         ## $         *      
#######       ######    ####       ####            $*  
#######       ###############  $  ######      ####     
###### *       ##############     #######    #####     
###### *       $############       ######   #######    
######              #######    $   #####$   #######    
#####             **  #####*  $*  $          #######  $
#####            $     ###                    ######   
                       ###                 $  $#####   
  *               *    ####                 $   ####   
 $                    #######            $       ### * 
   $           *     ##########$       *               
        #     *     ############ $     *        $ *    
    *  ###         *   $ **######        *             
       #####                ######                     
     * #####         $        #####   *                
       ######                                ######    
       ######                              ############
       ###### *   ####               *     ############
       ######  ##########        *  *      ############
  $    ####################  $            #############
    $   ###    ############               #############
 $   *          ############    * $     *######        
  *              ###########            ######         
 *                ##########*     $     #####   *      
                  ########## $ *$       #####          
                 *########## *  $   *   ####   *       
 *     *     $     #########  *$        ####           
