36 87
#########              ##################### *$* #          ######################     
#########           *  #####################$   ##       *  ######################     
#########              ########   #######    #####           ####################      
#########*         $  #########  *  ###      ######          ####################      
#########            #########         *     #####            ############   ####      
#########    *   *  #########                #####            ##########   *           
########            #########               ######            #########      *         
########            #########                #####    *        #######             $###
########         $  #########                ##### *           #######            #####
#######           $   #######                 ####     *        ####             ######
#######               *#######     * *                *###              $        ######
######                   #####                        #####                      ######
######                    ###    $  #                 ######                      #####
###### *      $          *    * * ####                #####  $              *     #####
######           *   $  $         #### *        *   *    $*     $$*         *      ####
######      $ $               *   ####$                              *       *     ####
######           $ *     $        ####           * *    *            $      $       ###
#######                           ####                     *                        ###
#########                    $ *  ####   *                          *             $ ###
##########           #    *      #####             * $    $       *                ####
#### #####          ####         ######     ####                  *     *     *   #####
##     ####    *    #####       #################              *####          *  ######
        ###      *  #####*      ##################              #####  *     * ########
  $     *####        #####       #################          $   ######     *   ########
         ######       #### $       ##############   $            #####    $    ########
   *  $    ####   *     ##$          ###########             *   #####          #######
  @  $          $      $            $ ##########      *         * ####     *     ######
                                      #####   *        *         $ ###           $#####
            $     **      ###  *       ###                          ###                
                         ####                     *                 ###                
                         ##### $                *            *      ###      $ $       
              @         ######                        **            ##       $         
$     $                ########    ##     *                         ##      *         $
            $  * $  ###################                   **        ## $      *        
                   ####################$  >        *          *     #                 *
           *       ####################                $            #         $        
