56 94
       #########         #####                                 *               #########      
       #########         #####                                                  ########      
       ########  *       #####                         *                        ########      
  *    *#######          #####                                                   ######       
        ######           ####                                                     ###         
          ##     *       ####                           *              *                      
$                        ####   *                                          *  $               
                         ######                                                   $           
             *          ##########                       *      *                             
                       #############                                                          
               *       ##############                                                         
         *         *  ###############                   *               #####                 
                $    ################                                 ########                
                  ###################      *           *             #########                
      *           ###################         *                      ##########               
                  #####  ############                                #########             * *
              $           ##########                                ##########        *       
   $          *            #########                                 ########               * 
     #######               ######### *         ##    *                ######     *            
    ########              ##########     *   ######            *     *  ##         #          
    #########             #########          #############                        ###         
    #########  $          #########         ###############                      ####         
 *  #########      *       #########        ###############                 $   #####    *    
     #######               #########      #################            *        ######        
     #######                ##############################                     #######        
      ######              * #############################              $      #######        $
      ######     $          ########################                         ########         
      ######                 #####################             *             ########         
      ######    >     ####     ###################                            ######          
     ########       #######       ################                            ######          
   ###########    ########         ###############                             #####          
##########################          ##############                  *          ####        ###
###########################          #############                              ###       ####
###########################          ############                               ###      #####
###########################     *    ############                               ###      #####
###########################           ###########                               ###      #####
#################  ########           ##########                       $                  ####
################*     ####            ##########               * *                         ###
###############                       #########                    $                         #
        #####            *            ########                                                
           *                           ######                     *     ###                   
                                       ####                            ##### $                
#####                                                                  ######         *       
######                                            #####      ###       ######                 
#######          *                               ################ *    ######                 
########                                         #################     ######         *       
#########                                        #################                            
##############  $                                #################                  ######    
##############          $                        #################                 ###########
##############                                    ################                 ###########
#############       *                              ################ ###           ############
  ###########                                       ####################          ############
    #########                              *         ####################         ############
     ########          *                             ###################### *   *#############
     ########                                        ########################    #############
     ########                                         ########################  ##############
