5 26
 ####*              $*  * 
 #####          *#       $
  ####   #*   # ### *    >
 $#### *###   ###       * 
  ###    ##    ##       $#
