63 80
         ###           #########                        ########             ###
        *###           ########                *        ########              ##
        #####     *    ########                         ########              ##
       ######         ########                          #######                 
       #######      #########                             #####                 
      ########     #########                                                    
      ########     ########                                                     
      ########     ########               *                                     
     #########      #######      *                         $             *      
    #########         ######            >                                *      
############           ######                      #      #######     *         
###########            #######                    ###   ##########              
#######                ########  ####            ##################             
                       ################         ####################            
                       #################        #####################           
                       #################       ######################           
              #       ####################   ####### ################           
                      ##############################*###############*           
*         *  *         #############################################            
                       ############################################         *   
                        #################  ########################          *  
                        #####    #######     ####################               
                        ####     ######       #############                    *
                         ##       #####        ##########                       
                                   ###          ########              *         
                                                 ######                         
                                                                                
     *                                                                          
                                                                                
       ####                                                                     
       ######                                                                   
       #########                                                                
 *     ###########                                  *                         * 
        ###########                                                             
         ###########                                                         $  
          ##########                     *    *               *                 
           ##########*                                 *    ###               ##
           ##########                         ####         #####            ####
            #########              *        #######       ######      *    #####
            ##########                     ########      #######           #####
             #########                     ########      ######             ####
                    ##                     #######         ##         *         
                    * #                     #####                            *  
###                   ###      *                                                
####                  ####       *                                              
####                  #####                                        *            
###                  #######                                   *                
                     ############                                               
                    ###############                                             
                   #################        *                      *            
              #########################               #              ####  #####
            ############################ **          ###            ############
           #############################             ###           #############
          ####################      ###               ##          ##############
           ##################                         ###         ########      
           ##################                          ##         #######       
######       ################                                     #######       
########     ################                                      ##########   
########      ###############   *                                   ############
########      ###############      *        #####                   ############
########      ################             #############    *      #############
########      #################*     $     #############        *  #############
########      #################            #############          ##############
