10 10
######## #
# *      #
#     *  #
#        #
 >******  
#      * #
#  *   * #
#      * #
   *****  
######## #