65 27
   ######### *     #       
*  #########       #       
$  #########   *  ##$ *    
*  ###########   ####$     
  ################### *  * 
  ######  * #########*$   #
   ####  *    #######    ##
    #            ####    ##
 *                ###     #
       *         * #     * 
*         **               
         * *      #   * $  
**         ###   ##        
 *     ########*         * 
   $  ########      *      
 *   ########        *     
    #######           *    
*   #### *       $*      ##
     ##  *      *       ###
 *    *       *        $###
                ###########
          $    ############
*          *   ############
   $            ###########
   * ##         ####       
  * ####           *       
 * ######  #####  *  * *   
################           
################          #
*  #############       ####
 *   * ########      ######
     $    ####      #######
  $  **##           #######
       ###  $*      *   ###
  $   ########      *      
* $   #########            
      ##########          *
$ *   ##########           
      #########       *  $ 
                           
$         *  $  *     $    
*                          
 *$     *           ###    
            *   *  #####   
                 #######   
               ######### * 
        *      ########   >
  $           ##########$  
              *## *  ###   
$        $           ####  
                 $ $  ## *$
      *      *  ## $*      
     *     *    ##  *      
       *#       *#         
   $   ###       ** *      
       ###                 
#      ####       $      ##
# *  * #####$         *  ##
# *    ######    *       ##
#      ######    *   $    #
#      #######       $    #
##    ########  *        ##
##############*          ##
##############           ##
#############            ##
