57 48
         #######$             $       ####  **  
         #######                      ####      
    *    ######                       ####      
  $   * $ #####           $           ###     ##
$   *     ####             *         ####   *###
  *       ####                      #####       
          ####                 *   ######  *    
        $#####                    #######    $  
        #######                  ########*      
#      ########         *      * #######        
###   ############   $  *    *   $   *       $  
####  #######   ###                             
#####  #####     ##           ##                
####   #### $    ###          ###         ######
    #####        ###       $  ####       #######
*   ####         ####          ###   $   #######
   #####*        ####$           ##    $ *######
 $######         ####              ####     ####
#######      $     #        *      ####      ###
#######  *                    *    ####      ###
#######                  $    $    ###        ##
########              ###        $ ###         #
#########            #####       #####          
##########   $       #####      #####           
###########         ######$     #####         ##
  #######################        ###         ###
   ######################          $        ####
   ###############   ###  $         $   $   ####
 ** ########  *           $ $              #####
     ####                         *       ######
      #                   ##              ######
                          ###             ######
                 *       *###              #####
            #### $                       $  ####
    *      #######     $     $   * *         ###
           ######### $       $   $  *       $ ##
     * $  ############ $ $ $          *       ##
          ###############*                      
           #################*    *   >          
             ###############                    
      *        *############         $          
                 ##### $            $$          
              $             ###               $ 
       $             $      ####              * 
#######                     #####               
#########                   ######              
##########                 *#############       
###########            *     #############      
############ *                ############  $   
   #########                       ######## $   
      #######                       #######     
  $    ######*                 $     ###### *   
      $#####                  $     ########    
      ######              ####      #########   
   *########*            #####    * ########### 
   #########          *  #####     #############
  *#########             #####     #############
