6 6
######
#    #
#> * #
#*  *#
#   $#
######