42 95
                   *####           ##########     *         #             #####*         ######
                    ####           ##########              ###*          *####*          ######
     *           *  ###            #########               ####          #####          *######
                     ##            #########              ######        #####           #######
                  *  ##             ########              #######     #######           #######
#           ##      ####             #######              ##################            #######
###        #############      *       ######              ##################            #######
####       #############               #####    ###       ##################         *  #######
#####      #############*    *          ####  #####       *################       *  $   ######
#####      #############                ###*  ######        ###############              ######
######      ############*  *             *     ####           ############                     
#####        ###########                        ###          #############           $   *     
#####         *#########                            * *     ##############            *        
#####           ########                           $      * ###############                 ** 
####             ########               ##                  ######################             
####             ########  *            #    *               #######################          *
####      *      #########        ##                 *                ################         
####             #########       ####   *         *            *        ###############     *  
####           > #########      #####                                   ###############        
####               #######      #####     *               *          * * ################   ###
###                  ######    #####           *                        #######################
###                     ##     #####               *                    #######################
##                             #####          *                        ########################
                 *             #####                                  #########################
     ######                   *######             ####               *#########################
   ########                   ########           ######              ####################    * 
   ######### *              ###########          ######      *       ####################      
  ##########     *         ############           ####                ###################      
 ###########  *       **   ############                                #################       
 ############            * ########### *                                #####   ########       
  ###########     *                #    *                                       ########       
 $  #########*          *                                                        #######       
      ######               *                    *                      *         #######       
         #         $                                                             #######       
                      *                                                          #######       
*                             *                 *                                 ######       
                                                                 *         ###      ###        
            *                 ######                                      ####                 
*      ####        *        ##########       *  *                        ######                
      #####               * ########### *                               #######       *       *
    ########               #############  ###             *     *       #######                
    ########               ############# ####                           #######                
