14 90
     #####      **          $           $ ###           *       *    ####### * *       ###
     #####      *         $$              ###            *           #######  $       ####
$$*  #####$      $     $ *                ###                 $     ########          ####
     ###  *   #### *          *         *       $                  ######### $   #  $#####
       *    #######   $        **     * **             *        *###########  *###########
 $          ########* *      *##                          $     ############   ###########
$     *     #########  $     ####               $ *   *      *$ #######       ############
          * #########    *  *###          $                     ######      * ############
            #########      $         $          $####        $  ###### *       ###########
            ##########       *                  #####  $$        #####           #########
            ##########                     *   #######        $  ####            $#####   
        $   ##########  *     *       $     * ########  **        ###  $      $$   ###    
       $    ##########   $*    $   *       $ #########            ##$  >       $    ##    
            ##########                      ###########    #   $   #              * ##    
