29 77
####################              ############  $    *         ##         ###
####################               ###########     $       *$ ###          ##
#########   #######            *     ##########   $ *   $  $* ###            
####    * * #######   *              ############            #####           
####        ##### $      $           ##############         ######           
####       #####                 $$  ###############     ##########       $  
####    *  ####   $                  ################  *###########$  *      
####       ####*                 * *#################     *########    #     
#### *$   ######     $          #####################    $   ####### #####   
####     #######               ######################     $*   ############ $
###  *   ########    $          #####################     $        ##########
###$     ########                ####################*              #########
### $    #######  *    ##        *  * ###############            ** #########
###      #######      ####             ############## $    ###*      ########
          #####       #####            #############      #####   *   #######
   *   $   ####        #####          #############       #####              
                          ## *      ##############*        #### $   **     **
           *                       ###############        $  #    $          
                             $ * >$##############  *                     *  *
  *            $            $   * ###     ######  *     *                    
 *         *          *   *       ##      #####                              
          $###               *    ##        ## *                             
          ####                    #                                        $ 
          #####                   #                                          
   ###     #####                          $ $                                
    #      ######                                     *                      
            #######     *  *                                           $     
         $  #######                  $                               ###     
  $   $     #######      $     *                     $               ####    
