86 69
####################          ###############    *                   
####################          ###############      *                 
###################            ##############           *    *       
 ##################     $      ##############                        
  #################         $  ##############    *   *         *     
   ###############           *  ##############                       
   ###############              ##############                       
  ###############               ###############                      
  ##############                ###############                      
  ##############                ################     ######          
  ##############                ################    #################
   #############                ################   ##################
    ############                         #######   ##################
     ############                         ######    #################
      #############                    *  ####### * #################
           *   ######                     ########   ################
          *     ######           *        ########      #############
                ######                    #########   *    ##########
       *         #####                    #########           #######
                 #####    *              ##########             #####
                  ####          *        ##########      *      *####
   ####           ####                  ##########     *         ####
########          ####                  ########                 ####
########    *     ####             *    ######                   ####
#########    *   ######                 ####     *               ####
#########        ######                                 ###        ##
 *              ########     *                      $ * ####         
  $           ##########                                ####         
            ############                             *  #####   *    
             ###########                                #####        
    *         ##########    *                           ######       
               #########               *                 ############
     *          ########                *       *   $     ###########
                #######     *                            $     ######
                #######       *                       *        ######
                #######         $                               #####
 *               #####                                           ####
 *                ####                                           ####
                   ###       ###*                                 ###
######       *    *####    ######                                   #
######             ##############                                    
#######            ##############      ###  *                    *   
######          * ###############     #####                          
######           ################    #######                         
#####            ############################    *                   
                ############################# $                      
                ##############################          *            
            #   ##############################             *   #     
                  ############################                ###    
 *         * *       #########################                ##     
                         ##############   ###                   $   *
                           ########## *                              
                            #######           *                      
                             #####                            $ *    
*                              ###                   *               
                               ###         *               *         
                               ####   *                      *       
####                          #####                                  
#####                    *   #######                          *      
#####                        #######                     *           
######                      ########                                $
######         *           #########                                 
######        ##           ########                                  
######       #####*         #######                  *               
######       ######         #######                    $             
######       ######          ######   *   *                  #  *    
######       #######   *      ##### $                        ##      
####       * #######        *  ###             *             ###     
             #######       >                                 ####    
             #######                                *        ####### 
              ######                                     * #######   
              ######              $  *                   #####      $
    *          #####   *                          *     #####        
         *      ###    *        $                      ######        
                                                       #####         
              *             $                  *      #####          
#####              ###                            ########           
######            ####                           ######## *          
#######          #####                           ########        *   
#######         ######  $                        ########            
####### *       ######  *                        ########            
#######        #######                           #######            #
########   $  ########       *                  ########           ##
  ######      ########   *           ##        ####               ###
  ######     #########             ########  ######               ###
   #####   * #########            #################   *           ###
