10 26
##########################
# $   *  ########       $#
#     $  ########        #
#        ########        #
#   *    ########        #
#>                       #
#  $     ########   $ *  #
#        ########        #
# *   $  ########       $#
##########################