8 17
   ##    >       
   ##       $#   
   ##  ### $###  
 *  $ ###$   ####
     ####      ##
     ## $####* ##
    ###  ###   ##
#  * ##  ##    ##
