17 42
     *   $     #### *          #      $$  
     *         ####      *     #    *  *  
         #     #####      $             $ 
       ####   #####          **     ###   
    $  ####$  #####        ####     ######
       ####  ###### * * ########     #####
             ######   #########       ####
             ###### $ ######## *      $  #
    *     ########     ** ###            #
         #########  *      ##      *  $###
## *     ######### * $    ###         ####
###      ########$        ###      *  ####
 ##     * ##         *    ###        $####
  *                       $          #####
   ##         $        $     $      $#####
   ####         >          *       * #####
   ####   $#      *       *   $      #####
