5 36
##         ### ### ## ###      #####
##   *     ###  #      ##  $  ##  ##
###    * *    $>  $   $#    ####    
###  *                 #   #####    
##       @  *      *@ ###  #####    
