50 84
##                                                                            $     
##$                     *          $  $                   *                       $ 
       $                                                          # $  $            
                     $                                         ######              $
                                               ###    #### ###########              
  $ *    $     $               *        ####  ####    ################    $         
            $                          ##########      ###############              
                                      ########   $     ###############              
    *     $                          ########           ##############              
                    $             ###########           ##############              
        $                         ###########            #############    $         
                  *                  ########              ###########         *  ##
                                     ########               ##########           ###
*$  $                                ########                 #########         ####
                 $                   ########*                 ########         ####
                                     ########                  *#######         ####
       ##$               $          ########                $   #######          ###
      ####       *      >    $      ########          *         $#######$        ###
      ####                           #######                     #######   $        
 *    ####         ###      *         #####           *          ########        *  
      ###         #####   #####        ####                      ########  $       *
              $   #############$                   ##            ##########      $  
                  ############                     ###    $      ###########        
   $             #############            *        ###            ###########       
                 ############              $       ###             ###########      
                 ############                                 *   *   ########      
           ### ##############                         *                #######      
         #####################                          $$              ######      
#       ######################                $                         ######$     
####  ##########################                                        #######     
##################################                                     ########     
###################################                                  ##########     
###################################            $                   ############     
###################################      $                       ###############    
########         ##################     $   $         *         ################    
#######          #################                             ################    $
######          $ ###############  *     $                     ###############      
#####     $       ##############                              * ############    ####
  *               #############                                 ###########     ####
                   ############      $                           ##########     ####
                   ##########    $                               #########      $###
      ###           #######                     $  $              ########        ##
      #####               $                *          #        $  ########    $     
      ######                                         ####    $    #########         
      #######       *                                  ##      $   ########         
      #######                                             *        #######          
      ######     $        $   *                                  * #######          
       #####              #       $     $   *                      #####            
       ####              ###       $                                ###        $  $ 
        ###              ####                                      $ #       $      
