39 39
   ####      ##                        
   ####      ##                        
    ###      ##        ##            ##
          #####       ###           ###
         #####         ##           ###
  $     #####                 * $    ##
$*   $#   ##                         ##
     ##                              ##
#######  $      ##             ##     #
#######     $   $#        $    ###     
 #####           ##            ##      
   #              #  *     *   *       
              *                        
                   ###      $          
            ##     ####$         >     
##$        ####     #####      $       
### *      #####    ########     ######
### *   ## ######   #######      ######
###     # $ ######    ###      ########
###*             ##          $#########
####      *        *         ##########
#####  *              ##   * ##########
#####                 ##     ##########
#####   @  ##         ##     ##########
###       ######      ###    ##########
  $       ########    #### $ ###  #####
         *########*   ####       ###   
##*       ###############        ##  $ 
###        ###   ########       ###    
####       ###    #################    
####       ##       ################   
#####    *  #         ##############*  
####                    #######        
####   ## @               *            
###   ####                             
#     ####  $     *                  $ 
     #####           *                 
    ######               *         $ ##
    ######                    *     ###
