70 49
        ############             #########       
        ############             ########        
        ############             ########        
        ############              ######         
        #############              #####         
        #############                  $         
         ############                            
          ###########                            
####       ##########              *             
####         #                                   
####                                             
####                         *                   
#######                                          
########                        ##           ####
#########                      ####          # $ 
##########                    ######             
#########                     ######             
####                          ######             
##                                               
   *            $                                
                                                 
                                         ###     
     *                              $    #####   
                                        #######  
                     #                  #########
                     #                  #########
                    ###           *     #########
 *                  ##                  #########
   ##               ##                   ########
#######                                  ########
#######                                  ########
########                                 ########
########                                  #######
########            *                     #######
########                    *              ######
#######                                      ####
####              #      ###                  ###
##            *   *     #####                   #
                     ########         ###  *     
                    #########        ####        
                    ########   >    #####        
                    ########         ####        
#                   #######           ###        
##                  ######                       
##                  #####                        
##                    ##                       * 
                                                 
                                                 
         ##                                      
        ####                                     
        ####                            ###      
       ######                         ######     
       ######            ##        ##########    
       ######           ####      ###########    
      ########          #####     ###########    
     ##########         #####     #########      
    ##############      #####       #####        
   #################    #####                    
   ##################                            
   ##################                            
      ############### *                          
       ##############                 ###########
        ############           ##################
        ############          ###################
         ###########          ###################
#         ###########         ###################
#           ##########        ###################
             ##########            #########     
              ###########           #######      
*             ###########           #######      
